,Handle,Propagate,Raise,Remap,Rethrow,Addition,Removal,All
0,3243,3266,667,782,0,0,0,7958
0,3243,3266,667,782,0,0,0,7958
0,3243,3266,667,782,0,0,0,7958
0,615,840,150,175,0,0,0,1780
0,615,840,150,175,0,0,0,1780
0,615,840,150,175,0,0,0,1780
0,10166,1000,635,350,0,0,0,12151
0,10166,1000,635,350,0,0,0,12151
0,10166,1000,635,350,0,0,0,12151
0,10166,1000,635,350,0,0,0,12151
0,10166,1000,635,350,0,0,0,12151
0,2022,2325,470,545,0,0,0,5362
0,2022,2325,470,545,0,0,0,5362
0,2022,2325,470,545,0,0,0,5362
0,2022,2325,470,545,0,0,0,5362
0,2022,2325,470,545,0,0,0,5362
0,2022,2325,470,545,0,0,0,5362
0,2022,2325,470,545,0,0,0,5362
0,2022,2325,470,545,0,0,0,5362
0,2022,2325,470,545,0,0,0,5362
0,2022,2325,470,545,0,0,0,5362
0,21363,14280,4767,8859,0,0,0,49269
0,21363,14280,4767,8859,0,0,0,49269
0,21363,14280,4767,8859,0,0,0,49269
0,21363,14280,4767,8859,0,0,0,49269
0,21363,14280,4767,8859,0,0,0,49269
0,21363,14280,4767,8859,0,0,0,49269
0,32,10,0,0,0,0,0,42
0,32,10,0,0,0,0,0,42
0,32,10,0,0,0,0,0,42
0,32,10,0,0,0,0,0,42
0,32,10,0,0,0,0,0,42
0,34,50,32,0,0,0,0,116
0,34,50,32,0,0,0,0,116
0,32,48,30,0,0,0,0,110
0,32,48,30,0,0,0,0,110
0,32,48,30,0,0,0,0,110
0,32,48,30,0,0,0,0,110
0,32,48,30,0,0,0,0,110
0,580,228,76,228,0,0,0,1112
0,580,228,76,228,0,0,0,1112
0,580,228,76,228,0,0,0,1112
0,580,228,76,228,0,0,0,1112
0,580,228,76,228,0,0,0,1112
0,580,228,76,228,0,0,0,1112
0,580,228,76,228,0,0,0,1112
0,580,228,76,228,0,0,0,1112
0,580,228,76,228,0,0,0,1112
0,580,228,76,228,0,0,0,1112
0,580,228,76,228,0,0,0,1112
0,580,228,76,228,0,0,0,1112
0,1507,1197,152,684,0,0,0,3540
0,1507,1197,152,684,0,0,0,3540
0,1507,1197,152,684,0,0,0,3540
0,1507,1197,152,684,0,0,0,3540
0,1507,1197,152,684,0,0,0,3540
0,1507,1197,152,684,0,0,0,3540
0,1507,1197,152,684,0,0,0,3540
0,1507,1197,152,684,0,0,0,3540
0,7024,3078,494,1102,0,0,0,11698
0,7024,3078,494,1102,0,0,0,11698
0,7024,3078,494,1102,0,0,0,11698
0,7024,3078,494,1102,0,0,0,11698
0,7024,3078,494,1102,0,0,0,11698
0,435,171,19,57,0,0,0,682
0,435,171,19,57,0,0,0,682
0,435,171,19,57,0,0,0,682
0,435,171,19,57,0,0,0,682
0,435,171,19,57,0,0,0,682
0,435,171,19,57,0,0,0,682
0,435,171,19,57,0,0,0,682
0,435,171,19,57,0,0,0,682
0,248242,520104,125914,305914,0,0,0,1200174
0,248242,520104,125914,305914,0,0,0,1200174
0,248242,520104,125914,305914,0,0,0,1200174
0,248242,520104,125914,305914,0,0,0,1200174
0,248242,520104,125914,305914,0,0,0,1200174
0,12,33,12,3,0,0,0,60
0,12,33,12,3,0,0,0,60
0,12,33,12,3,0,0,0,60
0,12,33,12,3,0,0,0,60
0,12,33,12,3,0,0,0,60
0,6047,11058,2771,425,0,0,0,20301
0,6047,11058,2771,425,0,0,0,20301
0,6047,11058,2771,425,0,0,0,20301
0,6047,11058,2771,425,0,0,0,20301
0,6047,11058,2771,425,0,0,0,20301
0,6047,11058,2771,425,0,0,0,20301
0,6047,11058,2771,425,0,0,0,20301
0,6047,11058,2771,425,0,0,0,20301
0,26008,19478,5405,0,0,0,0,50891
0,26008,19478,5405,0,0,0,0,50891
0,26008,19478,5405,0,0,0,0,50891
0,26008,19478,5405,0,0,0,0,50891
0,26008,19478,5405,0,0,0,0,50891
0,26008,18239,5405,0,0,0,0,49652
0,26008,18239,5405,0,0,0,0,49652
0,26008,18239,5405,0,0,0,0,49652
0,26008,18239,5405,0,0,0,0,49652
0,26008,18239,5405,0,0,0,0,49652
