,Handle,Propagate,Raise,Remap,Rethrow,Addition,Removal,All
0,14996,12213,8878,3634,943,0,0,40664
0,14996,12213,8878,3634,943,0,0,40664
0,14996,12213,8878,3634,943,0,0,40664
0,3705,3605,2505,1255,355,0,0,11425
0,3705,3605,2505,1255,355,0,0,11425
0,3705,3605,2505,1255,355,0,0,11425
0,49781,36171,27710,15727,150,0,0,129539
0,49781,36171,27710,15727,150,0,0,129539
0,49781,36171,27710,15727,150,0,0,129539
0,49781,36171,27710,15727,150,0,0,129539
0,49781,36171,27710,15727,150,0,0,129539
0,11167,11421,7585,4129,1155,0,0,35457
0,11167,11421,7585,4129,1155,0,0,35457
0,11167,11421,7585,4129,1155,0,0,35457
0,11167,11421,7585,4129,1155,0,0,35457
0,11167,11421,7585,4129,1155,0,0,35457
0,11167,11421,7585,4129,1155,0,0,35457
0,11167,11421,7585,4129,1155,0,0,35457
0,11167,11421,7585,4129,1155,0,0,35457
0,11167,11421,7585,4129,1155,0,0,35457
0,11167,11421,7585,4129,1155,0,0,35457
0,227781,148383,163512,38181,963,0,0,578820
0,227781,148383,163512,38181,963,0,0,578820
0,227781,148383,163512,38181,963,0,0,578820
0,227781,148383,163512,38181,963,0,0,578820
0,227781,148383,163512,38181,963,0,0,578820
0,227781,148383,163512,38181,963,0,0,578820
0,118,110,82,90,10,0,0,410
0,118,110,82,90,10,0,0,410
0,118,110,82,90,10,0,0,410
0,118,110,82,90,10,0,0,410
0,118,110,82,90,10,0,0,410
0,97,228,167,186,0,0,0,678
0,97,228,167,186,0,0,0,678
0,88,206,150,176,0,0,0,620
0,88,206,150,176,0,0,0,620
0,88,206,150,176,0,0,0,620
0,88,206,150,176,0,0,0,620
0,88,206,150,176,0,0,0,620
0,2760,953,1308,664,228,0,0,5913
0,2760,953,1308,664,228,0,0,5913
0,2760,953,1308,664,228,0,0,5913
0,2760,953,1308,664,228,0,0,5913
0,2760,953,1308,664,228,0,0,5913
0,2760,953,1308,664,228,0,0,5913
0,2760,953,1308,664,228,0,0,5913
0,2760,953,1308,664,228,0,0,5913
0,2760,953,1308,664,228,0,0,5913
0,2760,953,1308,664,228,0,0,5913
0,2760,953,1308,664,228,0,0,5913
0,2760,953,1308,664,228,0,0,5913
0,9351,3000,4809,2971,171,0,0,20302
0,9351,3000,4809,2971,171,0,0,20302
0,9351,3000,4809,2971,171,0,0,20302
0,9351,3000,4809,2971,171,0,0,20302
0,9351,3000,4809,2971,171,0,0,20302
0,9351,3000,4809,2971,171,0,0,20302
0,9351,3000,4809,2971,171,0,0,20302
0,9351,3000,4809,2971,171,0,0,20302
0,28098,12656,14400,9208,475,0,0,64837
0,28098,12656,14400,9208,475,0,0,64837
0,28098,12656,14400,9208,475,0,0,64837
0,28098,12656,14400,9208,475,0,0,64837
0,28098,12656,14400,9208,475,0,0,64837
0,1557,691,658,384,0,0,0,3290
0,1557,691,658,384,0,0,0,3290
0,1557,691,658,384,0,0,0,3290
0,1557,691,658,384,0,0,0,3290
0,1557,691,658,384,0,0,0,3290
0,1557,691,658,384,0,0,0,3290
0,1557,691,658,384,0,0,0,3290
0,1557,691,658,384,0,0,0,3290
0,5531127,2249584,3524771,1402650,65924,0,0,12774056
0,5531127,2249584,3524771,1402650,65924,0,0,12774056
0,5531127,2249584,3524771,1402650,65924,0,0,12774056
0,5531127,2249584,3524771,1402650,65924,0,0,12774056
0,5531127,2249584,3524771,1402650,65924,0,0,12774056
0,60,63,63,39,0,0,0,225
0,60,63,63,39,0,0,0,225
0,60,63,63,39,0,0,0,225
0,60,63,63,39,0,0,0,225
0,60,63,63,39,0,0,0,225
0,32688,20351,17411,12056,1009,0,0,83515
0,32688,20351,17411,12056,1009,0,0,83515
0,32688,20351,17411,12056,1009,0,0,83515
0,32688,20351,17411,12056,1009,0,0,83515
0,32688,20351,17411,12056,1009,0,0,83515
0,32688,20351,17411,12056,1009,0,0,83515
0,32688,20351,17411,12056,1009,0,0,83515
0,32688,20351,17411,12056,1009,0,0,83515
0,78855,63873,51756,40304,2714,0,0,237502
0,78855,63873,51756,40304,2714,0,0,237502
0,78855,63873,51756,40304,2714,0,0,237502
0,78855,63873,51756,40304,2714,0,0,237502
0,78855,63873,51756,40304,2714,0,0,237502
0,78855,62634,51756,40304,2714,0,0,236263
0,78855,62634,51756,40304,2714,0,0,236263
0,78855,62634,51756,40304,2714,0,0,236263
0,78855,62634,51756,40304,2714,0,0,236263
0,78855,62634,51756,40304,2714,0,0,236263
