,Handle,Propagate,Raise,Remap,Rethrow,Addition,Removal,All
0,9384,3565,1173,1679,0,7935,92,23828
0,9384,3565,1173,1679,0,7935,92,23828
0,9384,3565,1173,1679,0,7935,92,23828
0,2670,905,260,370,0,2445,20,6670
0,2670,905,260,370,0,2445,20,6670
0,2670,905,260,370,0,2445,20,6670
0,41786,3310,1765,11600,0,46310,0,104771
0,41786,3310,1765,11600,0,46310,0,104771
0,41786,3310,1765,11600,0,46310,0,104771
0,41786,3310,1765,11600,0,46310,0,104771
0,41786,3310,1765,11600,0,46310,0,104771
0,8935,2630,1020,1460,0,8743,60,22848
0,8935,2630,1020,1460,0,8743,60,22848
0,8935,2630,1020,1460,0,8743,60,22848
0,8935,2630,1020,1460,0,8743,60,22848
0,8935,2630,1020,1460,0,8743,60,22848
0,8935,2630,1020,1460,0,8743,60,22848
0,8935,2630,1020,1460,0,8743,60,22848
0,8935,2630,1020,1460,0,8743,60,22848
0,8935,2630,1020,1460,0,8743,60,22848
0,8935,2630,1020,1460,0,8743,60,22848
0,327102,46020,43458,22710,0,394617,4596,838503
0,327102,46020,43458,22710,0,394617,4596,838503
0,327102,46020,43458,22710,0,394617,4596,838503
0,327102,46020,43458,22710,0,394617,4596,838503
0,327102,46020,43458,22710,0,394617,4596,838503
0,327102,46020,43458,22710,0,394617,4596,838503
0,47,35,50,75,0,175,10,392
0,47,35,50,75,0,175,10,392
0,47,35,50,75,0,175,10,392
0,47,35,50,75,0,175,10,392
0,47,35,50,75,0,175,10,392
0,178,165,120,408,0,755,0,1626
0,178,165,120,408,0,755,0,1626
0,162,154,114,374,0,694,0,1498
0,162,154,114,374,0,694,0,1498
0,162,154,114,374,0,694,0,1498
0,162,154,114,374,0,694,0,1498
0,162,154,114,374,0,694,0,1498
0,1574,247,228,912,0,1849,0,4810
0,1574,247,228,912,0,1849,0,4810
0,1574,247,228,912,0,1849,0,4810
0,1574,247,228,912,0,1849,0,4810
0,1574,247,228,912,0,1849,0,4810
0,1574,247,228,912,0,1849,0,4810
0,1574,247,228,912,0,1849,0,4810
0,1574,247,228,912,0,1849,0,4810
0,1574,247,228,912,0,1849,0,4810
0,1574,247,228,912,0,1849,0,4810
0,1574,247,228,912,0,1849,0,4810
0,1574,247,228,912,0,1849,0,4810
0,6519,1976,1026,4617,0,10598,0,24736
0,6519,1976,1026,4617,0,10598,0,24736
0,6519,1976,1026,4617,0,10598,0,24736
0,6519,1976,1026,4617,0,10598,0,24736
0,6519,1976,1026,4617,0,10598,0,24736
0,6519,1976,1026,4617,0,10598,0,24736
0,6519,1976,1026,4617,0,10598,0,24736
0,6519,1976,1026,4617,0,10598,0,24736
0,21753,4693,2774,14250,0,31772,0,75242
0,21753,4693,2774,14250,0,31772,0,75242
0,21753,4693,2774,14250,0,31772,0,75242
0,21753,4693,2774,14250,0,31772,0,75242
0,21753,4693,2774,14250,0,31772,0,75242
0,1228,209,133,779,0,1667,0,4016
0,1228,209,133,779,0,1667,0,4016
0,1228,209,133,779,0,1667,0,4016
0,1228,209,133,779,0,1667,0,4016
0,1228,209,133,779,0,1667,0,4016
0,1228,209,133,779,0,1667,0,4016
0,1228,209,133,779,0,1667,0,4016
0,1228,209,133,779,0,1667,0,4016
0,7213498,1070739,462473,1499336,0,9045872,0,19291918
0,7213498,1070739,462473,1499336,0,9045872,0,19291918
0,7213498,1070739,462473,1499336,0,9045872,0,19291918
0,7213498,1070739,462473,1499336,0,9045872,0,19291918
0,7213498,1070739,462473,1499336,0,9045872,0,19291918
0,186,96,48,138,0,408,0,876
0,186,96,48,138,0,408,0,876
0,186,96,48,138,0,408,0,876
0,186,96,48,138,0,408,0,876
0,186,96,48,138,0,408,0,876
0,14702,16273,11783,3604,0,26129,68,72559
0,14702,16273,11783,3604,0,26129,68,72559
0,14702,16273,11783,3604,0,26129,68,72559
0,14702,16273,11783,3604,0,26129,68,72559
0,14702,16273,11783,3604,0,26129,68,72559
0,14702,16273,11783,3604,0,26129,68,72559
0,14702,16273,11783,3604,0,26129,68,72559
0,14702,16273,11783,3604,0,26129,68,72559
0,80544,33301,28255,0,0,94041,2832,238973
0,80544,33301,28255,0,0,94041,2832,238973
0,80544,33301,28255,0,0,94041,2832,238973
0,80544,33301,28255,0,0,94041,2832,238973
0,80544,33301,28255,0,0,94041,2832,238973
0,79305,29584,24538,0,0,86607,2832,222866
0,79305,29584,24538,0,0,86607,2832,222866
0,79305,29584,24538,0,0,86607,2832,222866
0,79305,29584,24538,0,0,86607,2832,222866
0,79305,29584,24538,0,0,86607,2832,222866
