,Handle,Propagate,Raise,Remap,Rethrow,Addition,Removal,All
0,17434,12512,8303,2369,253,7613,7406,55890
0,17434,12512,8303,2369,253,7613,7406,55890
0,17434,12512,8303,2369,253,7613,7406,55890
0,4900,3670,2255,520,55,2360,2385,16145
0,4900,3670,2255,520,55,2360,2385,16145
0,4900,3670,2255,520,55,2360,2385,16145
0,70007,38136,26230,13740,150,42746,24022,215031
0,70007,38136,26230,13740,150,42746,24022,215031
0,70007,38136,26230,13740,150,42746,24022,215031
0,70007,38136,26230,13740,150,42746,24022,215031
0,70007,38136,26230,13740,150,42746,24022,215031
0,15357,11726,6940,1975,165,8420,7714,52297
0,15357,11726,6940,1975,165,8420,7714,52297
0,15357,11726,6940,1975,165,8420,7714,52297
0,15357,11726,6940,1975,165,8420,7714,52297
0,15357,11726,6940,1975,165,8420,7714,52297
0,15357,11726,6940,1975,165,8420,7714,52297
0,15357,11726,6940,1975,165,8420,7714,52297
0,15357,11726,6940,1975,165,8420,7714,52297
0,15357,11726,6940,1975,165,8420,7714,52297
0,15357,11726,6940,1975,165,8420,7714,52297
0,473742,180123,188589,42018,891,342804,36261,1264428
0,473742,180123,188589,42018,891,342804,36261,1264428
0,473742,180123,188589,42018,891,342804,36261,1264428
0,473742,180123,188589,42018,891,342804,36261,1264428
0,473742,180123,188589,42018,891,342804,36261,1264428
0,473742,180123,188589,42018,891,342804,36261,1264428
0,105,135,107,165,10,150,38,710
0,105,135,107,165,10,150,38,710
0,105,135,107,165,10,150,38,710
0,105,135,107,165,10,150,38,710
0,105,135,107,165,10,150,38,710
0,223,325,255,560,0,694,9,2066
0,223,325,255,560,0,694,9,2066
0,202,296,234,518,0,638,8,1896
0,202,296,234,518,0,638,8,1896
0,202,296,234,518,0,638,8,1896
0,202,296,234,518,0,638,8,1896
0,202,296,234,518,0,638,8,1896
0,2882,972,1248,1140,228,1441,884,8795
0,2882,972,1248,1140,228,1441,884,8795
0,2882,972,1248,1140,228,1441,884,8795
0,2882,972,1248,1140,228,1441,884,8795
0,2882,972,1248,1140,228,1441,884,8795
0,2882,972,1248,1140,228,1441,884,8795
0,2882,972,1248,1140,228,1441,884,8795
0,2882,972,1248,1140,228,1441,884,8795
0,2882,972,1248,1140,228,1441,884,8795
0,2882,972,1248,1140,228,1441,884,8795
0,2882,972,1248,1140,228,1441,884,8795
0,2882,972,1248,1140,228,1441,884,8795
0,11157,3741,5020,5719,171,7849,2343,36000
0,11157,3741,5020,5719,171,7849,2343,36000
0,11157,3741,5020,5719,171,7849,2343,36000
0,11157,3741,5020,5719,171,7849,2343,36000
0,11157,3741,5020,5719,171,7849,2343,36000
0,11157,3741,5020,5719,171,7849,2343,36000
0,11157,3741,5020,5719,171,7849,2343,36000
0,11157,3741,5020,5719,171,7849,2343,36000
0,33968,13986,14531,19019,475,25230,8088,115297
0,33968,13986,14531,19019,475,25230,8088,115297
0,33968,13986,14531,19019,475,25230,8088,115297
0,33968,13986,14531,19019,475,25230,8088,115297
0,33968,13986,14531,19019,475,25230,8088,115297
0,1753,729,670,950,0,1361,549,6012
0,1753,729,670,950,0,1361,549,6012
0,1753,729,670,950,0,1361,549,6012
0,1753,729,670,950,0,1361,549,6012
0,1753,729,670,950,0,1361,549,6012
0,1753,729,670,950,0,1361,549,6012
0,1753,729,670,950,0,1361,549,6012
0,1753,729,670,950,0,1361,549,6012
0,10621800,2800215,3637178,2095286,62108,7626408,1183877,28026872
0,10621800,2800215,3637178,2095286,62108,7626408,1183877,28026872
0,10621800,2800215,3637178,2095286,62108,7626408,1183877,28026872
0,10621800,2800215,3637178,2095286,62108,7626408,1183877,28026872
0,10621800,2800215,3637178,2095286,62108,7626408,1183877,28026872
0,219,114,87,174,0,375,6,975
0,219,114,87,174,0,375,6,975
0,219,114,87,174,0,375,6,975
0,219,114,87,174,0,375,6,975
0,219,114,87,174,0,375,6,975
0,32618,25549,24389,14792,1009,22261,7419,128037
0,32618,25549,24389,14792,1009,22261,7419,128037
0,32618,25549,24389,14792,1009,22261,7419,128037
0,32618,25549,24389,14792,1009,22261,7419,128037
0,32618,25549,24389,14792,1009,22261,7419,128037
0,32618,25549,24389,14792,1009,22261,7419,128037
0,32618,25549,24389,14792,1009,22261,7419,128037
0,32618,25549,24389,14792,1009,22261,7419,128037
0,117393,77696,70311,22073,2714,84542,31857,406586
0,117393,77696,70311,22073,2714,84542,31857,406586
0,117393,77696,70311,22073,2714,84542,31857,406586
0,117393,77696,70311,22073,2714,84542,31857,406586
0,117393,77696,70311,22073,2714,84542,31857,406586
0,116154,73979,66594,22073,2714,77108,31857,390479
0,116154,73979,66594,22073,2714,77108,31857,390479
0,116154,73979,66594,22073,2714,77108,31857,390479
0,116154,73979,66594,22073,2714,77108,31857,390479
0,116154,73979,66594,22073,2714,77108,31857,390479
