,Handle,Propagate,Raise,Remap,Rethrow,Addition,Removal,All
0,192,37,45,37,22,0,0,333
0,192,37,45,37,22,0,0,333
0,192,37,45,37,22,0,0,333
0,192,37,45,37,22,0,0,333
0,192,37,45,37,22,0,0,333
0,231,171,32,55,0,0,0,489
0,231,171,32,55,0,0,0,489
0,231,171,32,55,0,0,0,489
0,231,171,32,55,0,0,0,489
0,231,171,32,55,0,0,0,489
0,231,171,32,55,0,0,0,489
0,216,108,42,36,18,0,0,420
0,216,108,42,36,18,0,0,420
0,216,108,42,36,18,0,0,420
0,216,108,42,36,18,0,0,420
0,216,108,42,36,18,0,0,420
0,216,108,42,36,18,0,0,420
0,426,172,213,164,0,0,0,975
0,426,172,213,164,0,0,0,975
0,426,172,213,164,0,0,0,975
0,426,172,213,164,0,0,0,975
0,426,172,213,164,0,0,0,975
0,426,172,213,164,0,0,0,975
0,18,7,1,0,2,0,0,28
0,18,7,1,0,2,0,0,28
0,18,7,1,0,2,0,0,28
0,18,7,1,0,2,0,0,28
0,18,7,1,0,2,0,0,28
0,18,7,1,0,2,0,0,28
0,18,7,1,0,2,0,0,28
0,194,90,26,0,20,0,0,330
0,194,90,26,0,20,0,0,330
0,194,90,26,0,20,0,0,330
0,194,90,26,0,20,0,0,330
0,194,90,26,0,20,0,0,330
0,1284,372,105,18,127,0,0,1906
0,1284,372,105,18,127,0,0,1906
0,1284,372,105,18,127,0,0,1906
0,1284,372,105,18,127,0,0,1906
0,1284,372,105,18,127,0,0,1906
0,641,169,135,65,26,0,0,1036
0,641,169,135,65,26,0,0,1036
0,641,169,135,65,26,0,0,1036
0,641,169,135,65,26,0,0,1036
0,641,169,135,65,26,0,0,1036
0,1089,1341,1090,0,0,0,0,3520
0,1089,1341,1090,0,0,0,0,3520
0,1089,1341,1090,0,0,0,0,3520
0,1089,1341,1090,0,0,0,0,3520
0,1089,1341,1090,0,0,0,0,3520
0,1089,1341,1090,0,0,0,0,3520
0,1089,1341,1090,0,0,0,0,3520
0,2730,1974,1845,0,0,0,0,6549
0,2730,1974,1845,0,0,0,0,6549
0,2730,1974,1845,0,0,0,0,6549
0,1779,737,773,0,0,0,0,3289
0,1779,737,773,0,0,0,0,3289
0,1779,737,773,0,0,0,0,3289
0,1779,737,773,0,0,0,0,3289
0,1779,737,773,0,0,0,0,3289
0,1779,737,773,0,0,0,0,3289
0,1779,737,773,0,0,0,0,3289
0,560,878,188,0,0,0,0,1626
0,560,878,188,0,0,0,0,1626
0,560,878,188,0,0,0,0,1626
0,249,138,30,42,0,0,0,459
0,249,138,30,42,0,0,0,459
0,249,138,30,42,0,0,0,459
0,249,138,30,42,0,0,0,459
0,249,138,30,42,0,0,0,459
0,249,138,30,42,0,0,0,459
0,249,138,30,42,0,0,0,459
0,256,138,32,42,0,0,0,468
0,256,138,32,42,0,0,0,468
0,69,37,14,37,22,0,0,179
0,69,37,14,37,22,0,0,179
0,640,148,126,148,88,0,0,1150
0,640,148,126,148,88,0,0,1150
0,640,148,126,148,88,0,0,1150
0,640,148,126,148,88,0,0,1150
0,640,148,126,148,88,0,0,1150
0,618,259,128,259,154,0,0,1418
0,618,259,128,259,154,0,0,1418
0,618,259,128,259,154,0,0,1418
0,618,259,128,259,154,0,0,1418
0,618,259,128,259,154,0,0,1418
0,618,259,128,259,154,0,0,1418
0,618,259,128,259,154,0,0,1418
0,618,259,128,259,154,0,0,1418
0,618,259,128,259,154,0,0,1418
0,618,259,128,259,154,0,0,1418
0,618,259,128,259,154,0,0,1418
0,756,270,129,270,105,0,0,1530
0,756,270,129,270,105,0,0,1530
0,756,270,129,270,105,0,0,1530
0,756,270,129,270,105,0,0,1530
0,756,270,129,270,105,0,0,1530
0,756,270,129,270,105,0,0,1530
