,Handle,Propagate,Raise,Remap,Rethrow,Addition,Removal,All
0,897,904,546,819,161,0,0,3327
0,897,904,546,819,161,0,0,3327
0,897,904,546,819,161,0,0,3327
0,897,904,546,819,161,0,0,3327
0,897,904,546,819,161,0,0,3327
0,2199,1895,1968,962,265,0,0,7289
0,2199,1895,1968,962,265,0,0,7289
0,2199,1895,1968,962,265,0,0,7289
0,2199,1895,1968,962,265,0,0,7289
0,2199,1895,1968,962,265,0,0,7289
0,2199,1895,1968,962,265,0,0,7289
0,1012,498,634,582,162,0,0,2888
0,1012,498,634,582,162,0,0,2888
0,1012,498,634,582,162,0,0,2888
0,1012,498,634,582,162,0,0,2888
0,1012,498,634,582,162,0,0,2888
0,1012,498,634,582,162,0,0,2888
0,2648,1962,886,1445,180,0,0,7121
0,2648,1962,886,1445,180,0,0,7121
0,2648,1962,886,1445,180,0,0,7121
0,2648,1962,886,1445,180,0,0,7121
0,2648,1962,886,1445,180,0,0,7121
0,2648,1962,886,1445,180,0,0,7121
0,19,22,51,53,9,0,0,154
0,19,22,51,53,9,0,0,154
0,19,22,51,53,9,0,0,154
0,19,22,51,53,9,0,0,154
0,19,22,51,53,9,0,0,154
0,19,22,51,53,9,0,0,154
0,19,22,51,53,9,0,0,154
0,594,830,798,606,120,0,0,2948
0,594,830,798,606,120,0,0,2948
0,594,830,798,606,120,0,0,2948
0,594,830,798,606,120,0,0,2948
0,594,830,798,606,120,0,0,2948
0,2996,4020,4327,4248,727,0,0,16318
0,2996,4020,4327,4248,727,0,0,16318
0,2996,4020,4327,4248,727,0,0,16318
0,2996,4020,4327,4248,727,0,0,16318
0,2996,4020,4327,4248,727,0,0,16318
0,2011,3369,2055,2592,391,0,0,10418
0,2011,3369,2055,2592,391,0,0,10418
0,2011,3369,2055,2592,391,0,0,10418
0,2011,3369,2055,2592,391,0,0,10418
0,2011,3369,2055,2592,391,0,0,10418
0,23814,18284,14315,15395,1724,0,0,73532
0,23814,18284,14315,15395,1724,0,0,73532
0,23814,18284,14315,15395,1724,0,0,73532
0,23814,18284,14315,15395,1724,0,0,73532
0,23814,18284,14315,15395,1724,0,0,73532
0,23814,18284,14315,15395,1724,0,0,73532
0,23814,18284,14315,15395,1724,0,0,73532
0,37686,26253,21711,26847,3153,0,0,115650
0,37686,26253,21711,26847,3153,0,0,115650
0,37686,26253,21711,26847,3153,0,0,115650
0,15248,10015,8896,12504,1525,0,0,48188
0,15248,10015,8896,12504,1525,0,0,48188
0,15248,10015,8896,12504,1525,0,0,48188
0,15248,10015,8896,12504,1525,0,0,48188
0,15248,10015,8896,12504,1525,0,0,48188
0,15248,10015,8896,12504,1525,0,0,48188
0,15248,10015,8896,12504,1525,0,0,48188
0,6654,6600,7266,5250,936,0,0,26706
0,6654,6600,7266,5250,936,0,0,26706
0,6654,6600,7266,5250,936,0,0,26706
0,2158,901,1346,1095,78,0,0,5578
0,2158,901,1346,1095,78,0,0,5578
0,2158,901,1346,1095,78,0,0,5578
0,2158,901,1346,1095,78,0,0,5578
0,2158,901,1346,1095,78,0,0,5578
0,2158,901,1346,1095,78,0,0,5578
0,2158,901,1346,1095,78,0,0,5578
0,2233,983,1400,1112,78,0,0,5806
0,2233,983,1400,1112,78,0,0,5806
0,769,548,421,207,70,0,0,2015
0,769,548,421,207,70,0,0,2015
0,7220,6538,4278,3830,760,0,0,22626
0,7220,6538,4278,3830,760,0,0,22626
0,7220,6538,4278,3830,760,0,0,22626
0,7220,6538,4278,3830,760,0,0,22626
0,7220,6538,4278,3830,760,0,0,22626
0,6230,4007,3246,2480,617,0,0,16580
0,6230,4007,3246,2480,617,0,0,16580
0,6230,4007,3246,2480,617,0,0,16580
0,6230,4007,3246,2480,617,0,0,16580
0,6230,4007,3246,2480,617,0,0,16580
0,6230,4007,3246,2480,617,0,0,16580
0,6230,4007,3246,2480,617,0,0,16580
0,6230,4007,3246,2480,617,0,0,16580
0,6230,4007,3246,2480,617,0,0,16580
0,6230,4007,3246,2480,617,0,0,16580
0,6230,4007,3246,2480,617,0,0,16580
0,5801,4622,4069,2765,689,0,0,17946
0,5801,4622,4069,2765,689,0,0,17946
0,5801,4622,4069,2765,689,0,0,17946
0,5801,4622,4069,2765,689,0,0,17946
0,5801,4622,4069,2765,689,0,0,17946
0,5801,4622,4069,2765,689,0,0,17946
