,Handle,Propagate,Raise,Remap,Rethrow,Addition,Removal,All
0,278,37,81,120,40,229,6,791
0,278,37,81,120,40,229,6,791
0,278,37,81,120,40,229,6,791
0,278,37,81,120,40,229,6,791
0,278,37,81,120,40,229,6,791
0,370,219,461,58,58,681,4,1851
0,370,219,461,58,58,681,4,1851
0,370,219,461,58,58,681,4,1851
0,370,219,461,58,58,681,4,1851
0,370,219,461,58,58,681,4,1851
0,370,219,461,58,58,681,4,1851
0,270,108,190,74,74,296,0,1012
0,270,108,190,74,74,296,0,1012
0,270,108,190,74,74,296,0,1012
0,270,108,190,74,74,296,0,1012
0,270,108,190,74,74,296,0,1012
0,270,108,190,74,74,296,0,1012
0,615,200,473,178,96,589,2,2153
0,615,200,473,178,96,589,2,2153
0,615,200,473,178,96,589,2,2153
0,615,200,473,178,96,589,2,2153
0,615,200,473,178,96,589,2,2153
0,615,200,473,178,96,589,2,2153
0,18,8,18,6,6,28,0,84
0,18,8,18,6,6,28,0,84
0,18,8,18,6,6,28,0,84
0,18,8,18,6,6,28,0,84
0,18,8,18,6,6,28,0,84
0,18,8,18,6,6,28,0,84
0,18,8,18,6,6,28,0,84
0,302,92,290,70,70,496,2,1322
0,302,92,290,70,70,496,2,1322
0,302,92,290,70,70,496,2,1322
0,302,92,290,70,70,496,2,1322
0,302,92,290,70,70,496,2,1322
0,1570,436,1094,318,318,1841,11,5588
0,1570,436,1094,318,318,1841,11,5588
0,1570,436,1094,318,318,1841,11,5588
0,1570,436,1094,318,318,1841,11,5588
0,1570,436,1094,318,318,1841,11,5588
0,907,253,602,117,91,940,6,2916
0,907,253,602,117,91,940,6,2916
0,907,253,602,117,91,940,6,2916
0,907,253,602,117,91,940,6,2916
0,907,253,602,117,91,940,6,2916
0,4208,1367,6207,0,0,8304,42,20128
0,4208,1367,6207,0,0,8304,42,20128
0,4208,1367,6207,0,0,8304,42,20128
0,4208,1367,6207,0,0,8304,42,20128
0,4208,1367,6207,0,0,8304,42,20128
0,4208,1367,6207,0,0,8304,42,20128
0,4208,1367,6207,0,0,8304,42,20128
0,6930,2010,9102,0,0,11547,54,29643
0,6930,2010,9102,0,0,11547,54,29643
0,6930,2010,9102,0,0,11547,54,29643
0,3258,749,3429,0,0,4165,18,11619
0,3258,749,3429,0,0,4165,18,11619
0,3258,749,3429,0,0,4165,18,11619
0,3258,749,3429,0,0,4165,18,11619
0,3258,749,3429,0,0,4165,18,11619
0,3258,749,3429,0,0,4165,18,11619
0,3258,749,3429,0,0,4165,18,11619
0,1124,1000,2924,2,2,3440,14,8506
0,1124,1000,2924,2,2,3440,14,8506
0,1124,1000,2924,2,2,3440,14,8506
0,442,138,23,88,0,243,11,945
0,442,138,23,88,0,243,11,945
0,442,138,23,88,0,243,11,945
0,442,138,23,88,0,243,11,945
0,442,138,23,88,0,243,11,945
0,442,138,23,88,0,243,11,945
0,442,138,23,88,0,243,11,945
0,454,138,24,88,0,248,12,964
0,454,138,24,88,0,248,12,964
0,146,37,50,120,40,220,6,619
0,146,37,50,120,40,220,6,619
0,1224,148,262,480,160,1156,32,3462
0,1224,148,262,480,160,1156,32,3462
0,1224,148,262,480,160,1156,32,3462
0,1224,148,262,480,160,1156,32,3462
0,1224,148,262,480,160,1156,32,3462
0,1050,259,380,819,273,1420,57,4258
0,1050,259,380,819,273,1420,57,4258
0,1050,259,380,819,273,1420,57,4258
0,1050,259,380,819,273,1420,57,4258
0,1050,259,380,819,273,1420,57,4258
0,1050,259,380,819,273,1420,57,4258
0,1050,259,380,819,273,1420,57,4258
0,1050,259,380,819,273,1420,57,4258
0,1050,259,380,819,273,1420,57,4258
0,1050,259,380,819,273,1420,57,4258
0,1050,259,380,819,273,1420,57,4258
0,1071,270,388,843,281,1442,119,4414
0,1071,270,388,843,281,1442,119,4414
0,1071,270,388,843,281,1442,119,4414
0,1071,270,388,843,281,1442,119,4414
0,1071,270,388,843,281,1442,119,4414
0,1071,270,388,843,281,1442,119,4414
