,Handle,Propagate,Raise,Remap,Rethrow,Addition,Removal,All
0,897,904,353,816,130,170,397,3667
0,897,904,353,816,130,170,397,3667
0,897,904,353,816,130,170,397,3667
0,897,904,353,816,130,170,397,3667
0,897,904,353,816,130,170,397,3667
0,2209,1897,1985,835,197,430,596,8149
0,2209,1897,1985,835,197,430,596,8149
0,2209,1897,1985,835,197,430,596,8149
0,2209,1897,1985,835,197,430,596,8149
0,2209,1897,1985,835,197,430,596,8149
0,2209,1897,1985,835,197,430,596,8149
0,1066,498,734,564,164,170,32,3228
0,1066,498,734,564,164,170,32,3228
0,1066,498,734,564,164,170,32,3228
0,1066,498,734,564,164,170,32,3228
0,1066,498,734,564,164,170,32,3228
0,1066,498,734,564,164,170,32,3228
0,2827,1964,1022,1372,252,541,225,8203
0,2827,1964,1022,1372,252,541,225,8203
0,2827,1964,1022,1372,252,541,225,8203
0,2827,1964,1022,1372,252,541,225,8203
0,2827,1964,1022,1372,252,541,225,8203
0,2827,1964,1022,1372,252,541,225,8203
0,19,22,62,55,11,15,0,184
0,19,22,62,55,11,15,0,184
0,19,22,62,55,11,15,0,184
0,19,22,62,55,11,15,0,184
0,19,22,62,55,11,15,0,184
0,19,22,62,55,11,15,0,184
0,19,22,62,55,11,15,0,184
0,692,832,888,626,140,366,136,3680
0,692,832,888,626,140,366,136,3680
0,692,832,888,626,140,366,136,3680
0,692,832,888,626,140,366,136,3680
0,692,832,888,626,140,366,136,3680
0,3237,4025,4483,4214,724,1039,674,18396
0,3237,4025,4483,4214,724,1039,674,18396
0,3237,4025,4483,4214,724,1039,674,18396
0,3237,4025,4483,4214,724,1039,674,18396
0,3237,4025,4483,4214,724,1039,674,18396
0,2221,3375,2132,2458,356,706,582,11830
0,2221,3375,2132,2458,356,706,582,11830
0,2221,3375,2132,2458,356,706,582,11830
0,2221,3375,2132,2458,356,706,582,11830
0,2221,3375,2132,2458,356,706,582,11830
0,26191,18294,16513,12548,1476,7431,5941,88394
0,26191,18294,16513,12548,1476,7431,5941,88394
0,26191,18294,16513,12548,1476,7431,5941,88394
0,26191,18294,16513,12548,1476,7431,5941,88394
0,26191,18294,16513,12548,1476,7431,5941,88394
0,26191,18294,16513,12548,1476,7431,5941,88394
0,26191,18294,16513,12548,1476,7431,5941,88394
0,40683,26268,24861,22080,2829,10044,8973,135738
0,40683,26268,24861,22080,2829,10044,8973,135738
0,40683,26268,24861,22080,2829,10044,8973,135738
0,16168,10020,9946,10520,1417,3427,3544,55042
0,16168,10020,9946,10520,1417,3427,3544,55042
0,16168,10020,9946,10520,1417,3427,3544,55042
0,16168,10020,9946,10520,1417,3427,3544,55042
0,16168,10020,9946,10520,1417,3427,3544,55042
0,16168,10020,9946,10520,1417,3427,3544,55042
0,16168,10020,9946,10520,1417,3427,3544,55042
0,7028,6606,8692,3994,882,2628,2132,31962
0,7028,6606,8692,3994,882,2628,2132,31962
0,7028,6606,8692,3994,882,2628,2132,31962
0,2248,901,943,1094,42,243,593,6064
0,2248,901,943,1094,42,243,593,6064
0,2248,901,943,1094,42,243,593,6064
0,2248,901,943,1094,42,243,593,6064
0,2248,901,943,1094,42,243,593,6064
0,2248,901,943,1094,42,243,593,6064
0,2248,901,943,1094,42,243,593,6064
0,2323,983,944,1106,42,248,656,6302
0,2323,983,944,1106,42,248,656,6302
0,760,548,228,264,40,161,336,2337
0,760,548,228,264,40,161,336,2337
0,7370,6538,3006,3868,524,920,2240,24466
0,7370,6538,3006,3868,524,920,2240,24466
0,7370,6538,3006,3868,524,920,2240,24466
0,7370,6538,3006,3868,524,920,2240,24466
0,7370,6538,3006,3868,524,920,2240,24466
0,6073,4007,2259,2783,471,1007,1994,18594
0,6073,4007,2259,2783,471,1007,1994,18594
0,6073,4007,2259,2783,471,1007,1994,18594
0,6073,4007,2259,2783,471,1007,1994,18594
0,6073,4007,2259,2783,471,1007,1994,18594
0,6073,4007,2259,2783,471,1007,1994,18594
0,6073,4007,2259,2783,471,1007,1994,18594
0,6073,4007,2259,2783,471,1007,1994,18594
0,6073,4007,2259,2783,471,1007,1994,18594
0,6073,4007,2259,2783,471,1007,1994,18594
0,6073,4007,2259,2783,471,1007,1994,18594
0,5676,4622,2953,3072,506,1067,2184,20080
0,5676,4622,2953,3072,506,1067,2184,20080
0,5676,4622,2953,3072,506,1067,2184,20080
0,5676,4622,2953,3072,506,1067,2184,20080
0,5676,4622,2953,3072,506,1067,2184,20080
0,5676,4622,2953,3072,506,1067,2184,20080
