,Handle,Propagate,Raise,Remap,Rethrow,Addition,Removal,All
0,730,572,1098,780,354,0,0,3534
0,730,572,1098,780,354,0,0,3534
0,730,572,1098,780,354,0,0,3534
0,730,572,1098,780,354,0,0,3534
0,730,572,1098,780,354,0,0,3534
0,730,572,1098,780,354,0,0,3534
0,864,702,1257,844,390,0,0,4057
0,864,702,1257,844,390,0,0,4057
0,864,702,1257,844,390,0,0,4057
0,864,702,1257,844,390,0,0,4057
0,864,702,1257,844,390,0,0,4057
0,864,702,1257,844,390,0,0,4057
0,864,702,1257,844,390,0,0,4057
0,5560,6824,9672,9792,3174,0,0,35022
0,5560,6824,9672,9792,3174,0,0,35022
0,5560,6824,9672,9792,3174,0,0,35022
0,5560,6824,9672,9792,3174,0,0,35022
0,5560,6824,9672,9792,3174,0,0,35022
0,688,628,1074,712,296,0,0,3398
0,688,628,1074,712,296,0,0,3398
0,688,628,1074,712,296,0,0,3398
0,688,628,1074,712,296,0,0,3398
0,688,628,1074,712,296,0,0,3398
0,688,628,1074,712,296,0,0,3398
0,688,628,1074,712,296,0,0,3398
0,688,628,1074,712,296,0,0,3398
0,55,37,64,37,8,0,0,201
0,55,37,64,37,8,0,0,201
0,55,37,64,37,8,0,0,201
0,55,37,64,37,8,0,0,201
0,55,37,64,37,8,0,0,201
0,55,37,64,37,8,0,0,201
0,159,221,416,209,76,0,0,1081
0,159,221,416,209,76,0,0,1081
0,159,221,416,209,76,0,0,1081
0,159,221,416,209,76,0,0,1081
0,159,221,416,209,76,0,0,1081
0,159,221,416,209,76,0,0,1081
0,51,37,56,37,8,0,0,189
0,51,37,56,37,8,0,0,189
0,51,37,56,37,8,0,0,189
0,51,37,56,37,8,0,0,189
0,51,37,56,37,8,0,0,189
0,51,37,56,37,8,0,0,189
0,355,265,464,325,122,0,0,1531
0,355,265,464,325,122,0,0,1531
0,355,265,464,325,122,0,0,1531
0,355,265,464,325,122,0,0,1531
0,355,265,464,325,122,0,0,1531
0,355,265,464,325,122,0,0,1531
0,355,265,464,325,122,0,0,1531
0,8141,6039,12524,5311,2414,0,0,34429
0,8141,6039,12524,5311,2414,0,0,34429
0,8141,6039,12524,5311,2414,0,0,34429
0,8141,6039,12524,5311,2414,0,0,34429
0,8141,6039,12524,5311,2414,0,0,34429
0,8141,6039,12524,5311,2414,0,0,34429
0,8141,6039,12524,5311,2414,0,0,34429
0,387,265,434,325,140,0,0,1551
0,387,265,434,325,140,0,0,1551
0,387,265,434,325,140,0,0,1551
0,387,265,434,325,140,0,0,1551
0,387,265,434,325,140,0,0,1551
0,387,265,434,325,140,0,0,1551
0,387,265,434,325,140,0,0,1551
0,127,97,170,113,52,0,0,559
0,127,97,170,113,52,0,0,559
0,127,97,170,113,52,0,0,559
0,127,97,170,113,52,0,0,559
0,127,97,170,113,52,0,0,559
0,127,97,170,113,52,0,0,559
0,644,566,1021,664,296,0,0,3191
0,644,566,1021,664,296,0,0,3191
0,644,566,1021,664,296,0,0,3191
0,644,566,1021,664,296,0,0,3191
0,644,566,1021,664,296,0,0,3191
0,644,566,1021,664,296,0,0,3191
0,145,97,161,113,61,0,0,577
0,145,97,161,113,61,0,0,577
0,145,97,161,113,61,0,0,577
0,145,97,161,113,61,0,0,577
0,145,97,161,113,61,0,0,577
0,145,97,161,113,61,0,0,577
0,159,105,202,161,62,0,0,689
0,159,105,202,161,62,0,0,689
0,159,105,202,161,62,0,0,689
0,159,105,202,161,62,0,0,689
0,159,105,202,161,62,0,0,689
0,159,105,202,161,62,0,0,689
0,177,105,193,161,71,0,0,707
0,177,105,193,161,71,0,0,707
0,177,105,193,161,71,0,0,707
0,177,105,193,161,71,0,0,707
0,177,105,193,161,71,0,0,707
0,177,105,193,161,71,0,0,707
0,6517,4919,8788,4686,2493,0,0,27403
0,6517,4919,8788,4686,2493,0,0,27403
0,6517,4919,8788,4686,2493,0,0,27403
0,6517,4919,8788,4686,2493,0,0,27403
0,6517,4919,8788,4686,2493,0,0,27403
0,6517,4919,8788,4686,2493,0,0,27403
0,6517,4919,8788,4686,2493,0,0,27403
0,354,252,509,327,112,0,0,1554
0,354,252,509,327,112,0,0,1554
0,354,252,509,327,112,0,0,1554
0,354,252,509,327,112,0,0,1554
0,354,252,509,327,112,0,0,1554
0,354,252,509,327,112,0,0,1554
0,354,252,509,327,112,0,0,1554
0,141,96,203,161,56,0,0,657
0,141,96,203,161,56,0,0,657
0,141,96,203,161,56,0,0,657
0,141,96,203,161,56,0,0,657
0,141,96,203,161,56,0,0,657
0,141,96,203,161,56,0,0,657
0,7950,5208,11268,4500,1932,0,0,30858
0,7950,5208,11268,4500,1932,0,0,30858
0,7950,5208,11268,4500,1932,0,0,30858
0,7950,5208,11268,4500,1932,0,0,30858
0,7950,5208,11268,4500,1932,0,0,30858
0,7950,5208,11268,4500,1932,0,0,30858
0,7950,5208,11268,4500,1932,0,0,30858
0,7950,5208,11268,4500,1932,0,0,30858
0,5887,4132,10644,6490,1079,0,0,28232
0,5887,4132,10644,6490,1079,0,0,28232
0,5887,4132,10644,6490,1079,0,0,28232
0,5887,4132,10644,6490,1079,0,0,28232
0,5887,4132,10644,6490,1079,0,0,28232
0,5887,4132,10644,6490,1079,0,0,28232
0,5887,4132,10644,6490,1079,0,0,28232
0,5887,4132,10644,6490,1079,0,0,28232
0,896,828,1634,1312,392,0,0,5062
0,896,828,1634,1312,392,0,0,5062
0,896,828,1634,1312,392,0,0,5062
0,896,828,1634,1312,392,0,0,5062
0,896,828,1634,1312,392,0,0,5062
0,896,828,1634,1312,392,0,0,5062
0,896,828,1634,1312,392,0,0,5062
0,896,828,1634,1312,392,0,0,5062
0,896,828,1634,1312,392,0,0,5062
0,896,828,1634,1312,392,0,0,5062
0,896,828,1634,1312,392,0,0,5062
0,896,828,1634,1312,392,0,0,5062
0,896,828,1634,1312,392,0,0,5062
0,896,828,1634,1312,392,0,0,5062
0,896,828,1634,1312,392,0,0,5062
0,896,828,1634,1312,392,0,0,5062
0,896,828,1634,1312,392,0,0,5062
0,896,828,1634,1312,392,0,0,5062
0,816,960,2000,1408,424,0,0,5608
0,816,960,2000,1408,424,0,0,5608
0,816,960,2000,1408,424,0,0,5608
0,816,960,2000,1408,424,0,0,5608
0,816,960,2000,1408,424,0,0,5608
0,816,960,2000,1408,424,0,0,5608
0,816,960,2000,1408,424,0,0,5608
0,816,960,2000,1408,424,0,0,5608
0,816,960,2000,1408,424,0,0,5608
0,816,960,2000,1408,424,0,0,5608
0,816,960,2000,1408,424,0,0,5608
0,816,960,2000,1408,424,0,0,5608
0,816,960,2000,1408,424,0,0,5608
0,816,960,2000,1408,424,0,0,5608
0,816,960,2000,1408,424,0,0,5608
0,816,960,2000,1408,424,0,0,5608
0,816,960,2000,1408,424,0,0,5608
0,816,960,2000,1408,424,0,0,5608
0,819,687,1046,706,262,0,0,3520
0,819,687,1046,706,262,0,0,3520
0,819,687,1046,706,262,0,0,3520
0,819,687,1046,706,262,0,0,3520
0,819,687,1046,706,262,0,0,3520
0,385,301,574,353,112,0,0,1725
0,385,301,574,353,112,0,0,1725
0,385,301,574,353,112,0,0,1725
0,385,301,574,353,112,0,0,1725
0,385,301,574,353,112,0,0,1725
0,16302,30483,40029,15396,3927,0,0,106137
0,16302,30483,40029,15396,3927,0,0,106137
0,16302,30483,40029,15396,3927,0,0,106137
0,16302,30483,40029,15396,3927,0,0,106137
0,16302,30483,40029,15396,3927,0,0,106137
0,3961,3129,5510,2870,1539,0,0,17009
0,3961,3129,5510,2870,1539,0,0,17009
0,3961,3129,5510,2870,1539,0,0,17009
0,3961,3129,5510,2870,1539,0,0,17009
0,3961,3129,5510,2870,1539,0,0,17009
0,12138,21810,27630,10448,2298,0,0,74324
0,12138,21810,27630,10448,2298,0,0,74324
0,12138,21810,27630,10448,2298,0,0,74324
0,12138,21810,27630,10448,2298,0,0,74324
0,12138,21810,27630,10448,2298,0,0,74324
0,2598,1894,3396,1892,962,0,0,10742
0,2598,1894,3396,1892,962,0,0,10742
0,2598,1894,3396,1892,962,0,0,10742
0,2598,1894,3396,1892,962,0,0,10742
0,2598,1894,3396,1892,962,0,0,10742
