,Handle,Propagate,Raise,Remap,Rethrow,Addition,Removal,All
0,468,180,210,1020,96,990,0,2964
0,468,180,210,1020,96,990,0,2964
0,468,180,210,1020,96,990,0,2964
0,468,180,210,1020,96,990,0,2964
0,468,180,210,1020,96,990,0,2964
0,468,180,210,1020,96,990,0,2964
0,534,210,220,1120,98,1165,0,3347
0,534,210,220,1120,98,1165,0,3347
0,534,210,220,1120,98,1165,0,3347
0,534,210,220,1120,98,1165,0,3347
0,534,210,220,1120,98,1165,0,3347
0,534,210,220,1120,98,1165,0,3347
0,534,210,220,1120,98,1165,0,3347
0,4764,1608,3822,7422,810,3042,0,21468
0,4764,1608,3822,7422,810,3042,0,21468
0,4764,1608,3822,7422,810,3042,0,21468
0,4764,1608,3822,7422,810,3042,0,21468
0,4764,1608,3822,7422,810,3042,0,21468
0,468,180,184,960,84,1002,0,2878
0,468,180,184,960,84,1002,0,2878
0,468,180,184,960,84,1002,0,2878
0,468,180,184,960,84,1002,0,2878
0,468,180,184,960,84,1002,0,2878
0,468,180,184,960,84,1002,0,2878
0,468,180,184,960,84,1002,0,2878
0,468,180,184,960,84,1002,0,2878
0,12,8,11,32,0,27,0,90
0,12,8,11,32,0,27,0,90
0,12,8,11,32,0,27,0,90
0,12,8,11,32,0,27,0,90
0,12,8,11,32,0,27,0,90
0,12,8,11,32,0,27,0,90
0,96,40,39,140,0,147,0,462
0,96,40,39,140,0,147,0,462
0,96,40,39,140,0,147,0,462
0,96,40,39,140,0,147,0,462
0,96,40,39,140,0,147,0,462
0,96,40,39,140,0,147,0,462
0,12,8,11,32,0,27,0,90
0,12,8,11,32,0,27,0,90
0,12,8,11,32,0,27,0,90
0,12,8,11,32,0,27,0,90
0,12,8,11,32,0,27,0,90
0,12,8,11,32,0,27,0,90
0,186,84,97,411,38,458,0,1274
0,186,84,97,411,38,458,0,1274
0,186,84,97,411,38,458,0,1274
0,186,84,97,411,38,458,0,1274
0,186,84,97,411,38,458,0,1274
0,186,84,97,411,38,458,0,1274
0,186,84,97,411,38,458,0,1274
0,6854,2170,1966,11575,1565,17468,5,41603
0,6854,2170,1966,11575,1565,17468,5,41603
0,6854,2170,1966,11575,1565,17468,5,41603
0,6854,2170,1966,11575,1565,17468,5,41603
0,6854,2170,1966,11575,1565,17468,5,41603
0,6854,2170,1966,11575,1565,17468,5,41603
0,6854,2170,1966,11575,1565,17468,5,41603
0,186,84,97,411,38,458,0,1274
0,186,84,97,411,38,458,0,1274
0,186,84,97,411,38,458,0,1274
0,186,84,97,411,38,458,0,1274
0,186,84,97,411,38,458,0,1274
0,186,84,97,411,38,458,0,1274
0,186,84,97,411,38,458,0,1274
0,69,32,37,166,14,169,0,487
0,69,32,37,166,14,169,0,487
0,69,32,37,166,14,169,0,487
0,69,32,37,166,14,169,0,487
0,69,32,37,166,14,169,0,487
0,69,32,37,166,14,169,0,487
0,426,160,149,830,70,872,0,2507
0,426,160,149,830,70,872,0,2507
0,426,160,149,830,70,872,0,2507
0,426,160,149,830,70,872,0,2507
0,426,160,149,830,70,872,0,2507
0,426,160,149,830,70,872,0,2507
0,69,32,37,166,14,169,0,487
0,69,32,37,166,14,169,0,487
0,69,32,37,166,14,169,0,487
0,69,32,37,166,14,169,0,487
0,69,32,37,166,14,169,0,487
0,69,32,37,166,14,169,0,487
0,93,40,45,188,22,223,0,611
0,93,40,45,188,22,223,0,611
0,93,40,45,188,22,223,0,611
0,93,40,45,188,22,223,0,611
0,93,40,45,188,22,223,0,611
0,93,40,45,188,22,223,0,611
0,93,40,45,188,22,223,0,611
0,93,40,45,188,22,223,0,611
0,93,40,45,188,22,223,0,611
0,93,40,45,188,22,223,0,611
0,93,40,45,188,22,223,0,611
0,93,40,45,188,22,223,0,611
0,4933,1560,1442,8235,1145,13181,0,30496
0,4933,1560,1442,8235,1145,13181,0,30496
0,4933,1560,1442,8235,1145,13181,0,30496
0,4933,1560,1442,8235,1145,13181,0,30496
0,4933,1560,1442,8235,1145,13181,0,30496
0,4933,1560,1442,8235,1145,13181,0,30496
0,4933,1560,1442,8235,1145,13181,0,30496
0,195,86,97,414,38,482,0,1312
0,195,86,97,414,38,482,0,1312
0,195,86,97,414,38,482,0,1312
0,195,86,97,414,38,482,0,1312
0,195,86,97,414,38,482,0,1312
0,195,86,97,414,38,482,0,1312
0,195,86,97,414,38,482,0,1312
0,99,40,45,188,22,241,0,635
0,99,40,45,188,22,241,0,635
0,99,40,45,188,22,241,0,635
0,99,40,45,188,22,241,0,635
0,99,40,45,188,22,241,0,635
0,99,40,45,188,22,241,0,635
0,6864,2094,2034,11676,1722,18264,0,42654
0,6864,2094,2034,11676,1722,18264,0,42654
0,6864,2094,2034,11676,1722,18264,0,42654
0,6864,2094,2034,11676,1722,18264,0,42654
0,6864,2094,2034,11676,1722,18264,0,42654
0,6864,2094,2034,11676,1722,18264,0,42654
0,6864,2094,2034,11676,1722,18264,0,42654
0,6864,2094,2034,11676,1722,18264,0,42654
0,6954,2173,2630,12448,2084,20151,0,46440
0,6954,2173,2630,12448,2084,20151,0,46440
0,6954,2173,2630,12448,2084,20151,0,46440
0,6954,2173,2630,12448,2084,20151,0,46440
0,6954,2173,2630,12448,2084,20151,0,46440
0,6954,2173,2630,12448,2084,20151,0,46440
0,6954,2173,2630,12448,2084,20151,0,46440
0,6954,2173,2630,12448,2084,20151,0,46440
0,740,172,232,900,132,1262,0,3438
0,740,172,232,900,132,1262,0,3438
0,740,172,232,900,132,1262,0,3438
0,740,172,232,900,132,1262,0,3438
0,740,172,232,900,132,1262,0,3438
0,740,172,232,900,132,1262,0,3438
0,740,172,232,900,132,1262,0,3438
0,740,172,232,900,132,1262,0,3438
0,740,172,232,900,132,1262,0,3438
0,740,172,232,900,132,1262,0,3438
0,740,172,232,900,132,1262,0,3438
0,740,172,232,900,132,1262,0,3438
0,740,172,232,900,132,1262,0,3438
0,740,172,232,900,132,1262,0,3438
0,740,172,232,900,132,1262,0,3438
0,740,172,232,900,132,1262,0,3438
0,740,172,232,900,132,1262,0,3438
0,740,172,232,900,132,1262,0,3438
0,1016,224,296,1120,176,1768,0,4600
0,1016,224,296,1120,176,1768,0,4600
0,1016,224,296,1120,176,1768,0,4600
0,1016,224,296,1120,176,1768,0,4600
0,1016,224,296,1120,176,1768,0,4600
0,1016,224,296,1120,176,1768,0,4600
0,1016,224,296,1120,176,1768,0,4600
0,1016,224,296,1120,176,1768,0,4600
0,1016,224,296,1120,176,1768,0,4600
0,1016,224,296,1120,176,1768,0,4600
0,1016,224,296,1120,176,1768,0,4600
0,1016,224,296,1120,176,1768,0,4600
0,1016,224,296,1120,176,1768,0,4600
0,1016,224,296,1120,176,1768,0,4600
0,1016,224,296,1120,176,1768,0,4600
0,1016,224,296,1120,176,1768,0,4600
0,1016,224,296,1120,176,1768,0,4600
0,1016,224,296,1120,176,1768,0,4600
0,452,168,217,835,78,981,0,2731
0,452,168,217,835,78,981,0,2731
0,452,168,217,835,78,981,0,2731
0,452,168,217,835,78,981,0,2731
0,452,168,217,835,78,981,0,2731
0,227,86,108,427,40,517,0,1405
0,227,86,108,427,40,517,0,1405
0,227,86,108,427,40,517,0,1405
0,227,86,108,427,40,517,0,1405
0,227,86,108,427,40,517,0,1405
0,19368,1692,2040,7053,939,19887,51,51030
0,19368,1692,2040,7053,939,19887,51,51030
0,19368,1692,2040,7053,939,19887,51,51030
0,19368,1692,2040,7053,939,19887,51,51030
0,19368,1692,2040,7053,939,19887,51,51030
0,3027,936,898,4941,687,7931,0,18420
0,3027,936,898,4941,687,7931,0,18420
0,3027,936,898,4941,687,7931,0,18420
0,3027,936,898,4941,687,7931,0,18420
0,3027,936,898,4941,687,7931,0,18420
0,13726,1128,1116,4702,626,14008,34,35340
0,13726,1128,1116,4702,626,14008,34,35340
0,13726,1128,1116,4702,626,14008,34,35340
0,13726,1128,1116,4702,626,14008,34,35340
0,13726,1128,1116,4702,626,14008,34,35340
0,1954,624,556,3294,458,5266,0,12152
0,1954,624,556,3294,458,5266,0,12152
0,1954,624,556,3294,458,5266,0,12152
0,1954,624,556,3294,458,5266,0,12152
0,1954,624,556,3294,458,5266,0,12152
