,Handle,Propagate,Raise,Remap,Rethrow,Addition,Removal,All
0,850,572,1068,1278,396,936,306,5406
0,850,572,1068,1278,396,936,306,5406
0,850,572,1068,1278,396,936,306,5406
0,850,572,1068,1278,396,936,306,5406
0,850,572,1068,1278,396,936,306,5406
0,850,572,1068,1278,396,936,306,5406
0,1000,702,1224,1430,416,1093,378,6243
0,1000,702,1224,1430,416,1093,378,6243
0,1000,702,1224,1430,416,1093,378,6243
0,1000,702,1224,1430,416,1093,378,6243
0,1000,702,1224,1430,416,1093,378,6243
0,1000,702,1224,1430,416,1093,378,6243
0,1000,702,1224,1430,416,1093,378,6243
0,5626,6824,9648,10956,3948,3000,1020,41022
0,5626,6824,9648,10956,3948,3000,1020,41022
0,5626,6824,9648,10956,3948,3000,1020,41022
0,5626,6824,9648,10956,3948,3000,1020,41022
0,5626,6824,9648,10956,3948,3000,1020,41022
0,752,628,1048,1220,332,946,364,5290
0,752,628,1048,1220,332,946,364,5290
0,752,628,1048,1220,332,946,364,5290
0,752,628,1048,1220,332,946,364,5290
0,752,628,1048,1220,332,946,364,5290
0,752,628,1048,1220,332,946,364,5290
0,752,628,1048,1220,332,946,364,5290
0,752,628,1048,1220,332,946,364,5290
0,51,37,55,49,4,19,24,239
0,51,37,55,49,4,19,24,239
0,51,37,55,49,4,19,24,239
0,51,37,55,49,4,19,24,239
0,51,37,55,49,4,19,24,239
0,51,37,55,49,4,19,24,239
0,151,221,379,261,36,127,160,1335
0,151,221,379,261,36,127,160,1335
0,151,221,379,261,36,127,160,1335
0,151,221,379,261,36,127,160,1335
0,151,221,379,261,36,127,160,1335
0,151,221,379,261,36,127,160,1335
0,47,37,47,49,4,19,24,227
0,47,37,47,49,4,19,24,227
0,47,37,47,49,4,19,24,227
0,47,37,47,49,4,19,24,227
0,47,37,47,49,4,19,24,227
0,47,37,47,49,4,19,24,227
0,411,267,431,526,104,386,178,2303
0,411,267,431,526,104,386,178,2303
0,411,267,431,526,104,386,178,2303
0,411,267,431,526,104,386,178,2303
0,411,267,431,526,104,386,178,2303
0,411,267,431,526,104,386,178,2303
0,411,267,431,526,104,386,178,2303
0,11834,6049,11796,13759,3214,15983,3760,66395
0,11834,6049,11796,13759,3214,15983,3760,66395
0,11834,6049,11796,13759,3214,15983,3760,66395
0,11834,6049,11796,13759,3214,15983,3760,66395
0,11834,6049,11796,13759,3214,15983,3760,66395
0,11834,6049,11796,13759,3214,15983,3760,66395
0,11834,6049,11796,13759,3214,15983,3760,66395
0,443,267,401,526,122,386,178,2323
0,443,267,401,526,122,386,178,2323
0,443,267,401,526,122,386,178,2323
0,443,267,401,526,122,386,178,2323
0,443,267,401,526,122,386,178,2323
0,443,267,401,526,122,386,178,2323
0,443,267,401,526,122,386,178,2323
0,142,97,161,202,48,151,60,861
0,142,97,161,202,48,151,60,861
0,142,97,161,202,48,151,60,861
0,142,97,161,202,48,151,60,861
0,142,97,161,202,48,151,60,861
0,142,97,161,202,48,151,60,861
0,746,566,994,1091,321,827,300,4845
0,746,566,994,1091,321,827,300,4845
0,746,566,994,1091,321,827,300,4845
0,746,566,994,1091,321,827,300,4845
0,746,566,994,1091,321,827,300,4845
0,746,566,994,1091,321,827,300,4845
0,160,97,152,202,57,151,60,879
0,160,97,152,202,57,151,60,879
0,160,97,152,202,57,151,60,879
0,160,97,152,202,57,151,60,879
0,160,97,152,202,57,151,60,879
0,160,97,152,202,57,151,60,879
0,198,105,187,240,50,183,92,1055
0,198,105,187,240,50,183,92,1055
0,198,105,187,240,50,183,92,1055
0,198,105,187,240,50,183,92,1055
0,198,105,187,240,50,183,92,1055
0,198,105,187,240,50,183,92,1055
0,216,105,178,240,59,183,92,1073
0,216,105,178,240,59,183,92,1073
0,216,105,178,240,59,183,92,1073
0,216,105,178,240,59,183,92,1073
0,216,105,178,240,59,183,92,1073
0,216,105,178,240,59,183,92,1073
0,9273,4929,8322,10749,2783,11776,3123,50955
0,9273,4929,8322,10749,2783,11776,3123,50955
0,9273,4929,8322,10749,2783,11776,3123,50955
0,9273,4929,8322,10749,2783,11776,3123,50955
0,9273,4929,8322,10749,2783,11776,3123,50955
0,9273,4929,8322,10749,2783,11776,3123,50955
0,9273,4929,8322,10749,2783,11776,3123,50955
0,384,254,466,531,111,408,216,2370
0,384,254,466,531,111,408,216,2370
0,384,254,466,531,111,408,216,2370
0,384,254,466,531,111,408,216,2370
0,384,254,466,531,111,408,216,2370
0,384,254,466,531,111,408,216,2370
0,384,254,466,531,111,408,216,2370
0,180,96,188,240,53,201,101,1059
0,180,96,188,240,53,201,101,1059
0,180,96,188,240,53,201,101,1059
0,180,96,188,240,53,201,101,1059
0,180,96,188,240,53,201,101,1059
0,180,96,188,240,53,201,101,1059
0,12078,5208,10674,13392,3054,16698,3150,64254
0,12078,5208,10674,13392,3054,16698,3150,64254
0,12078,5208,10674,13392,3054,16698,3150,64254
0,12078,5208,10674,13392,3054,16698,3150,64254
0,12078,5208,10674,13392,3054,16698,3150,64254
0,12078,5208,10674,13392,3054,16698,3150,64254
0,12078,5208,10674,13392,3054,16698,3150,64254
0,12078,5208,10674,13392,3054,16698,3150,64254
0,11554,4132,10282,15831,3033,18108,1508,64448
0,11554,4132,10282,15831,3033,18108,1508,64448
0,11554,4132,10282,15831,3033,18108,1508,64448
0,11554,4132,10282,15831,3033,18108,1508,64448
0,11554,4132,10282,15831,3033,18108,1508,64448
0,11554,4132,10282,15831,3033,18108,1508,64448
0,11554,4132,10282,15831,3033,18108,1508,64448
0,11554,4132,10282,15831,3033,18108,1508,64448
0,1320,828,1524,1568,396,1098,524,7258
0,1320,828,1524,1568,396,1098,524,7258
0,1320,828,1524,1568,396,1098,524,7258
0,1320,828,1524,1568,396,1098,524,7258
0,1320,828,1524,1568,396,1098,524,7258
0,1320,828,1524,1568,396,1098,524,7258
0,1320,828,1524,1568,396,1098,524,7258
0,1320,828,1524,1568,396,1098,524,7258
0,1320,828,1524,1568,396,1098,524,7258
0,1320,828,1524,1568,396,1098,524,7258
0,1320,828,1524,1568,396,1098,524,7258
0,1320,828,1524,1568,396,1098,524,7258
0,1320,828,1524,1568,396,1098,524,7258
0,1320,828,1524,1568,396,1098,524,7258
0,1320,828,1524,1568,396,1098,524,7258
0,1320,828,1524,1568,396,1098,524,7258
0,1320,828,1524,1568,396,1098,524,7258
0,1320,828,1524,1568,396,1098,524,7258
0,1544,960,1864,1672,464,1576,680,8760
0,1544,960,1864,1672,464,1576,680,8760
0,1544,960,1864,1672,464,1576,680,8760
0,1544,960,1864,1672,464,1576,680,8760
0,1544,960,1864,1672,464,1576,680,8760
0,1544,960,1864,1672,464,1576,680,8760
0,1544,960,1864,1672,464,1576,680,8760
0,1544,960,1864,1672,464,1576,680,8760
0,1544,960,1864,1672,464,1576,680,8760
0,1544,960,1864,1672,464,1576,680,8760
0,1544,960,1864,1672,464,1576,680,8760
0,1544,960,1864,1672,464,1576,680,8760
0,1544,960,1864,1672,464,1576,680,8760
0,1544,960,1864,1672,464,1576,680,8760
0,1544,960,1864,1672,464,1576,680,8760
0,1544,960,1864,1672,464,1576,680,8760
0,1544,960,1864,1672,464,1576,680,8760
0,1544,960,1864,1672,464,1576,680,8760
0,977,691,961,1119,228,835,379,5190
0,977,691,961,1119,228,835,379,5190
0,977,691,961,1119,228,835,379,5190
0,977,691,961,1119,228,835,379,5190
0,977,691,961,1119,228,835,379,5190
0,431,303,519,570,113,441,230,2607
0,431,303,519,570,113,441,230,2607
0,431,303,519,570,113,441,230,2607
0,431,303,519,570,113,441,230,2607
0,431,303,519,570,113,441,230,2607
0,27846,30489,35901,16698,4407,18996,9792,144129
0,27846,30489,35901,16698,4407,18996,9792,144129
0,27846,30489,35901,16698,4407,18996,9792,144129
0,27846,30489,35901,16698,4407,18996,9792,144129
0,27846,30489,35901,16698,4407,18996,9792,144129
0,5637,3135,5208,6539,1713,7088,1865,31185
0,5637,3135,5208,6539,1713,7088,1865,31185
0,5637,3135,5208,6539,1713,7088,1865,31185
0,5637,3135,5208,6539,1713,7088,1865,31185
0,5637,3135,5208,6539,1713,7088,1865,31185
0,20584,21814,24740,12262,2618,13414,5720,101152
0,20584,21814,24740,12262,2618,13414,5720,101152
0,20584,21814,24740,12262,2618,13414,5720,101152
0,20584,21814,24740,12262,2618,13414,5720,101152
0,20584,21814,24740,12262,2618,13414,5720,101152
0,3694,1898,3216,4274,1078,4704,1286,20150
0,3694,1898,3216,4274,1078,4704,1286,20150
0,3694,1898,3216,4274,1078,4704,1286,20150
0,3694,1898,3216,4274,1078,4704,1286,20150
0,3694,1898,3216,4274,1078,4704,1286,20150
