,Handle,Propagate,Raise,Remap,Rethrow,Addition,Removal,All
0,264,180,114,426,0,0,0,984
0,264,180,114,426,0,0,0,984
0,264,180,114,426,0,0,0,984
0,264,180,114,426,0,0,0,984
0,264,180,114,426,0,0,0,984
0,264,180,114,426,0,0,0,984
0,286,210,115,406,0,0,0,1017
0,286,210,115,406,0,0,0,1017
0,286,210,115,406,0,0,0,1017
0,286,210,115,406,0,0,0,1017
0,286,210,115,406,0,0,0,1017
0,286,210,115,406,0,0,0,1017
0,286,210,115,406,0,0,0,1017
0,4584,1608,3012,6180,0,0,0,15384
0,4584,1608,3012,6180,0,0,0,15384
0,4584,1608,3012,6180,0,0,0,15384
0,4584,1608,3012,6180,0,0,0,15384
0,4584,1608,3012,6180,0,0,0,15384
0,252,180,94,348,0,0,0,874
0,252,180,94,348,0,0,0,874
0,252,180,94,348,0,0,0,874
0,252,180,94,348,0,0,0,874
0,252,180,94,348,0,0,0,874
0,252,180,94,348,0,0,0,874
0,252,180,94,348,0,0,0,874
0,252,180,94,348,0,0,0,874
0,8,8,8,12,0,0,0,36
0,8,8,8,12,0,0,0,36
0,8,8,8,12,0,0,0,36
0,8,8,8,12,0,0,0,36
0,8,8,8,12,0,0,0,36
0,8,8,8,12,0,0,0,36
0,64,40,24,40,0,0,0,168
0,64,40,24,40,0,0,0,168
0,64,40,24,40,0,0,0,168
0,64,40,24,40,0,0,0,168
0,64,40,24,40,0,0,0,168
0,64,40,24,40,0,0,0,168
0,8,8,8,12,0,0,0,36
0,8,8,8,12,0,0,0,36
0,8,8,8,12,0,0,0,36
0,8,8,8,12,0,0,0,36
0,8,8,8,12,0,0,0,36
0,8,8,8,12,0,0,0,36
0,84,82,54,130,8,0,0,358
0,84,82,54,130,8,0,0,358
0,84,82,54,130,8,0,0,358
0,84,82,54,130,8,0,0,358
0,84,82,54,130,8,0,0,358
0,84,82,54,130,8,0,0,358
0,84,82,54,130,8,0,0,358
0,1601,2160,751,2155,0,0,0,6667
0,1601,2160,751,2155,0,0,0,6667
0,1601,2160,751,2155,0,0,0,6667
0,1601,2160,751,2155,0,0,0,6667
0,1601,2160,751,2155,0,0,0,6667
0,1601,2160,751,2155,0,0,0,6667
0,1601,2160,751,2155,0,0,0,6667
0,84,82,54,130,8,0,0,358
0,84,82,54,130,8,0,0,358
0,84,82,54,130,8,0,0,358
0,84,82,54,130,8,0,0,358
0,84,82,54,130,8,0,0,358
0,84,82,54,130,8,0,0,358
0,84,82,54,130,8,0,0,358
0,36,32,22,59,0,0,0,149
0,36,32,22,59,0,0,0,149
0,36,32,22,59,0,0,0,149
0,36,32,22,59,0,0,0,149
0,36,32,22,59,0,0,0,149
0,36,32,22,59,0,0,0,149
0,234,160,74,295,0,0,0,763
0,234,160,74,295,0,0,0,763
0,234,160,74,295,0,0,0,763
0,234,160,74,295,0,0,0,763
0,234,160,74,295,0,0,0,763
0,234,160,74,295,0,0,0,763
0,36,32,22,59,0,0,0,149
0,36,32,22,59,0,0,0,149
0,36,32,22,59,0,0,0,149
0,36,32,22,59,0,0,0,149
0,36,32,22,59,0,0,0,149
0,36,32,22,59,0,0,0,149
0,36,40,22,59,8,0,0,165
0,36,40,22,59,8,0,0,165
0,36,40,22,59,8,0,0,165
0,36,40,22,59,8,0,0,165
0,36,40,22,59,8,0,0,165
0,36,40,22,59,8,0,0,165
0,36,40,22,59,8,0,0,165
0,36,40,22,59,8,0,0,165
0,36,40,22,59,8,0,0,165
0,36,40,22,59,8,0,0,165
0,36,40,22,59,8,0,0,165
0,36,40,22,59,8,0,0,165
0,1092,1550,262,1230,0,0,0,4134
0,1092,1550,262,1230,0,0,0,4134
0,1092,1550,262,1230,0,0,0,4134
0,1092,1550,262,1230,0,0,0,4134
0,1092,1550,262,1230,0,0,0,4134
0,1092,1550,262,1230,0,0,0,4134
0,1092,1550,262,1230,0,0,0,4134
0,74,84,54,128,8,0,0,348
0,74,84,54,128,8,0,0,348
0,74,84,54,128,8,0,0,348
0,74,84,54,128,8,0,0,348
0,74,84,54,128,8,0,0,348
0,74,84,54,128,8,0,0,348
0,74,84,54,128,8,0,0,348
0,24,40,22,59,8,0,0,153
0,24,40,22,59,8,0,0,153
0,24,40,22,59,8,0,0,153
0,24,40,22,59,8,0,0,153
0,24,40,22,59,8,0,0,153
0,24,40,22,59,8,0,0,153
0,1218,2094,750,2064,0,0,0,6126
0,1218,2094,750,2064,0,0,0,6126
0,1218,2094,750,2064,0,0,0,6126
0,1218,2094,750,2064,0,0,0,6126
0,1218,2094,750,2064,0,0,0,6126
0,1218,2094,750,2064,0,0,0,6126
0,1218,2094,750,2064,0,0,0,6126
0,1218,2094,750,2064,0,0,0,6126
0,598,2173,1157,2210,0,0,0,6138
0,598,2173,1157,2210,0,0,0,6138
0,598,2173,1157,2210,0,0,0,6138
0,598,2173,1157,2210,0,0,0,6138
0,598,2173,1157,2210,0,0,0,6138
0,598,2173,1157,2210,0,0,0,6138
0,598,2173,1157,2210,0,0,0,6138
0,598,2173,1157,2210,0,0,0,6138
0,284,172,94,316,48,0,0,914
0,284,172,94,316,48,0,0,914
0,284,172,94,316,48,0,0,914
0,284,172,94,316,48,0,0,914
0,284,172,94,316,48,0,0,914
0,284,172,94,316,48,0,0,914
0,284,172,94,316,48,0,0,914
0,284,172,94,316,48,0,0,914
0,284,172,94,316,48,0,0,914
0,284,172,94,316,48,0,0,914
0,284,172,94,316,48,0,0,914
0,284,172,94,316,48,0,0,914
0,284,172,94,316,48,0,0,914
0,284,172,94,316,48,0,0,914
0,284,172,94,316,48,0,0,914
0,284,172,94,316,48,0,0,914
0,284,172,94,316,48,0,0,914
0,284,172,94,316,48,0,0,914
0,256,224,112,408,64,0,0,1064
0,256,224,112,408,64,0,0,1064
0,256,224,112,408,64,0,0,1064
0,256,224,112,408,64,0,0,1064
0,256,224,112,408,64,0,0,1064
0,256,224,112,408,64,0,0,1064
0,256,224,112,408,64,0,0,1064
0,256,224,112,408,64,0,0,1064
0,256,224,112,408,64,0,0,1064
0,256,224,112,408,64,0,0,1064
0,256,224,112,408,64,0,0,1064
0,256,224,112,408,64,0,0,1064
0,256,224,112,408,64,0,0,1064
0,256,224,112,408,64,0,0,1064
0,256,224,112,408,64,0,0,1064
0,256,224,112,408,64,0,0,1064
0,256,224,112,408,64,0,0,1064
0,256,224,112,408,64,0,0,1064
0,200,164,129,260,16,0,0,769
0,200,164,129,260,16,0,0,769
0,200,164,129,260,16,0,0,769
0,200,164,129,260,16,0,0,769
0,200,164,129,260,16,0,0,769
0,88,84,63,128,8,0,0,371
0,88,84,63,128,8,0,0,371
0,88,84,63,128,8,0,0,371
0,88,84,63,128,8,0,0,371
0,88,84,63,128,8,0,0,371
0,6888,1686,1281,1401,0,0,0,11256
0,6888,1686,1281,1401,0,0,0,11256
0,6888,1686,1281,1401,0,0,0,11256
0,6888,1686,1281,1401,0,0,0,11256
0,6888,1686,1281,1401,0,0,0,11256
0,700,930,190,738,0,0,0,2558
0,700,930,190,738,0,0,0,2558
0,700,930,190,738,0,0,0,2558
0,700,930,190,738,0,0,0,2558
0,700,930,190,738,0,0,0,2558
0,4656,1124,610,934,0,0,0,7324
0,4656,1124,610,934,0,0,0,7324
0,4656,1124,610,934,0,0,0,7324
0,4656,1124,610,934,0,0,0,7324
0,4656,1124,610,934,0,0,0,7324
0,424,620,84,492,0,0,0,1620
0,424,620,84,492,0,0,0,1620
0,424,620,84,492,0,0,0,1620
0,424,620,84,492,0,0,0,1620
0,424,620,84,492,0,0,0,1620
